111111111111111111111111111
1000000000000000000000000E1
100111000111100011110111101
1001C100000C100000C1000C101
1001P1000011100001110000101
10000100000C100000C10000101
100011100111100011110000101
100000000000000000000000001
111111111111111111111111111
