1111111111111111111111
10100011111C1111111111
1010101111101111111111
1000000P00000000001111
1C11101011111010111011
11111110111000C0001011
1000111011101010111011
1010101011101110101011
1110111010001010111011
1000C00C101010000000E1
1111111111111111111111
1111101101100001111111
1111101101111101111111
1111100001100001111111
1111111101101111111111
1111111101100001111111
1111111111111111111111
