1111111111111
1001000C00001
1000011111001
1111011111001
1000011111001
100C011111001
1000011111001
10C0011111001
1100011111001
1P01111110011
111111E0000C1
1111111011011
1111111111111
