11111111111
1P0C1110E11
10001110111
11111111111
