1111111111111111111111
100P0C0E00011111111111
1111111111111111111111
1111111111111111111111
